10000000000000000000000000000099
00000000000000000000000000000099
00000000000000000000000000000099
00000000000000000000000000000099
00000000000000000000000000000099
00000000000000000000000000000000
00000000000000000000000000000000
00000000000000000000000000000000
00000000000099990000000000000000
00000000000099990000000000000000
00000000000099990000000000000000
00000000000099990000000000000000
99990000000000000000000000000000
00000000000000000000000000000000
00000000000000000000000000000000
00000000000000000000000000000002